Гадршина Алия Минефаритовна: semsch65_chelny@mail.ru 
Селивёрстова Наталья Николаевна: 
Большакова Светлана Владимировна: 
Ахметшина Анифа Камаевна: 
Батаева Людмила Александровна: 
Газизуллина Гузель Ансаровна: 
Набиуллина  Лиза  Рихмановна: gim2_chelny@mail.ru
Хамадеева  Альфия  Мансуровна: sch3_nabchelny@mail.ru
Шайхутдинова  Гузелия  Загитовна: sch7_chelny@mail.ru
Потапова  Лада  Вадимовна: sch9_chelny@mail.ru
Мосолкова  Елена  Петровна: sch11_nabchelny@mail.ru
Ульданова  Альбина  Фаилевна: sch13_chelny@mail.ru
Осипов Николай  Иванович: sch22_chelny@mail.ru
Бисеров  Ильгизар  Рустамович: sch24_chelny@mail.ru
Хлопцева  Юлия  Вячеславовна: sch25_chelny@mail.ru
Ионова  Галина  Михайловна: sch27_chelny@mail.ru
Ахметянов  Илдар  Гарифянович: sch28_chelny@mail.ru
Гатауллина  Луиза  Дамировна: gim29_chelny@mail.ru
Каримова  Алена  Сергеевна: sch30_chelny@mail.ru
Ярмиев  Марс  Расилович: sch31_chelny@mail.ru
Садриев  Рамиль  Шамилевич: sch34_chelny@mail.ru
Тухфатуллин  Ильгам  Ирекович: sch39_nabchelny@mail.ru
Автомеева  Олеся  Атласовна: sch43_chelny@mail.ru
Галеева  Файруза  Ниязовна: sch45_chelny@mail.ru
Нихолат  Ксения  Ильгизаровна: sch48chelny@mail.ru
Тухфатуллин  Булат  Ирекович: sch49_chelny@mail.ru
Нуриахметов  Дамир  Денисламович: sch52_chelny@mail.ru
Нурмухаметов  Алмаз  Рафиснурович: sch53_chelny@mail.ru
Зайнуллина  Рамзия  Наримановна: sch56_chelny@mail.ru
Федоренко  Елена  Борисовна: sch57_chelny@mail.ru
Гафуров  Марс  Рафгатович: sch62-chelny@mail.ru
Бариева   Гульнара Айратовна: gim77_chelny@mail.ru
Григорьев  Михаил  Юрьевич: licey78_chelny@mail.ru
Шарипова  Эльмира  Габдулахатовна: licey82_chelny@mail.ru
Аюпова  Фирдуса  Фанависовна: licey84_chelny@mail.ru
Абайдулин  Роберт  Нафисович: omet_chelny@mail.ru s86.nc@tatar.ru
Гаффарова  Халидя  Нургаеновна: Ss89.Nc@tatar.ru
Цыганов  Игорь  Васильевич: Del8.Nc@tatar.ru
Амирова Наталья Владимировна: 
Каримова  Марина  : school27n-kamsk@mail.ru
Султанова Наиля  Даутовна: spp@tatngpi.ru
Зиннатуллина Альбина  Сафиулловна: sch62-chelny@mail.ru
Зарипова Рая Салиховна: 
Тагирова Алена  Андреевна: DSport.Zarya@tatar.ru
Ахметшина Ринат Рустамович: Viktoriya.Nc@tatar
Костев Ион-Георгий Александрович: Chelny.Nc@tatar.ru
Григорьев  Михаил  Юрьевич: licey78_chelny@mail.ru
Кривых Валентина Вячеславовна: info@ntt-chelny.ru 
Силаичева  Ольга  Александровна: sch33_chelny@mail.ru
Фахриева  Альмира Салиховна: aaarrii@yandex.ru
Валиева Айгуль Миннефирдависовна: =#REF!
